█╣╠╠═╣╣╣╠╦
╗╬╦╩╔╝╠╣╦╦
╠╦╚╬╠╬╠╠╝╣
╬╚╣╗╩║╣╦╬╬
╬╔╦╚╬╩╝╩╦╦
╦╝╬╣╦╬╬╗╩║
║╗╩╩╩╩ ╩╩╩
╣╠╩╠╬║╗╦╣╩
╬╠╠╩╬╬╩╣╣╠
╩╬╩║╦╬═╬╠█
