█╝═╩╦╗╠╦╬╩
╣╬╣╠╬╬╣╩╝╦
╦╬╦╠╚╦╠╦╬╬
╣╣╬╦╩╬╠╬╦╬
╠╠╦╬╠╣╔╗╦╬
╠╩╠╦╬╦╬╩╦╗
╦╣║╦╩╠╬╬╣╚
╩╦╠╬╬╦╩╔╩╦
╠╠╦╩╬╦╩╩╬╗
╬╣╦╩╣╬╦╠╣█
