█╗╔╔═╦╦╔╔╗
╔╬╠╩╔╝╠╣╦╣
╠╦╚╬╠╬╝╠╝╣
╠╚╣╔╩║╣╦╬╣
╠╣╦╩╬╩╝╩╦╗
╔╝╬╣╦╬╬╗╩║
║╗╩╩╩╦ ╩╔╣
╠╠╩╠╬║╔╦╠╝
╠╠╠╩╬╚╩╣╣╣
╚╩╩╚╩╩═╩╚█
