█╣╠╠═╣╣╣╠╦
╗╬╦╩╬╝╠╣╦╦
╣╬╠╬╠╬╠╠╠╣
╬╣╣╗╩║╣╦╣╬
╬╔╦╦╬╩╬╩╦╦
╦║╬╣╦╬╗╦╩║
╦╗╩╬╬╩╦╩╣╩
╣╠╩╠╬║╗╦╣╩
╬╠╠╩╬╬╩╗╣╠
╣╠╩║╦╬═╬╠█
