█╗╦╦╦╔╦ ═╗
╠╬╦╣╦╠╠╦╩╣
╚╬╠╝╩╩╗╬╩╝
╠╣╩╬╣╦╣╠╬╝
║╣╣╠╣╦╩╠╩╗
╚╬╬╩╣╠╦╬╬╝
╠╬╩╝╬╩╩╠╬║
╔║╣╣╩╣╠╣╬╣
╚╣╬╬╩╦╩╬║╣
╚══╝╩═ ╩╩█
