█╦╔╔═╦══╗═╦╦╔╗═╗
╚╬╬╩╬╠╩╬╠╦╠╣╦╬╩╣
║╩╩╩╠╬╦╠╦╣╬╣╠╠╔╣
║╣╦╣╣╠╦╠╦╣╩╬╦╩╣╝
╠╣╬╠╔╩╣╠╦╠╬╝╦╩╠║
╠═╠╠╩╠╦╩╦╬╩╩╣╠╚╗
╔╦╬╣╩╣╬╔╔╦╣╦╣╦╚╣
║╩═╠╬╚╩╦╠╩╝╠╦║╩╗
╠╠╠╣╩╠║╬╬╩╠═╦╠╦║
╠╬╦╬╠╣╚╣╬╩╬╠╣╠╬╣
╚╬╠╣╬╣╣╠╣╩╔╚╣╦╦╗
╠╠╗╠═╣╣╦╩╦╠╣╠╦╬ 
╚═╣╩╦╬╩═╣╦╠╣╬╬╩╣
╠═╣╣╣╩╠╣╠╬╩╩╣╠╦ 
╚╣╗╠╦╩╔╣═╩║╦╠╦╦╗
╚═╝╩╝╚ ═ ╩╩╩╝═╚█
