█╦╦╗╔╔╗══ 
║╗╩╠╝╠╦╠╣╣
╠╠╠╔╬╣║╠╬╣
║╔╣╦╔╔╣╬╔╣
╠═╩╦╬╠╝╣╣╗
╚╝╠╣╠╣╦╦╣║
╠╠╩╠╣╦╬╣╬╣
 ╣╩╬╠║╠╬╩╣
╔╬╬╠╗╣╬╬╬ 
 ═╩╩╩╝═╝╚█
