█╗═╗╔╗╔╔╦ 
╠╗╚╩╠╦╬╩╩╣
╠╠╩╝╬╬╝╔╩╝
║╩╠╠╝╦╠╩╔╗
╚╦╦║╣╗╣╠╔╗
╔╦╣╬╠╠╬═╩ 
╔╔╝╬╠╣║╣╩║
╔╠╗╣╬╠╬╬╠╣
╠╩╩╠╗╠╠║╝╣
╚╩═╩╝╚╩╩═█
