█╦╗╦╦╗╗ ╦ 
 ═╠╦╣╬╣╣╦╣
 ╩═╩╣╠╬╠═║
╔╣╦╣╣╠╦╦╣║
 ╬╣╝╠╬╩╔╬╣
╚╣╣╦╬╣╔╠╬║
║╩╩╩╩╣╬╣╣║
╠╗╝╦╝╬╠╣╦║
╔╚╩╣╚╬╣╩╦╣
╚╩╚╩═╚╚╝╝█
