█═╦═╗╗╦╦═ 
╠╗╦╚╩╦╣╠╩║
╠╔╝╬╩╦╩╩╬╝
╠╠╬╩╣║╬╬╬║
║╦╦╩╠╩╬╦╬║
╠╠╠║║╬╩╣║║
╠═╣╣╬╩╦╬╦╣
╚╠╣╬╩╣╠╣╔║
 ╦╣╠╬╠╚╩╣╝
╚ ╝══╩╩╩╩█
