█╦══╦═╗╗╦╗
╚╠╦╬╩╩╩╣╦╗
╚╬╣╩╩╬╦╦╩╣
╚╩╩╠╠╣╬╩╣╣
╚╣╣╣╔╠╦╦╠║
╠╠╩╦╬╦╣╠╦║
╠╣╬╠╦╬╠║╬╣
║╩╦╬╩╠╦╠╬╣
╔╬╬╠╦╩╩╬╬║
╚═╩╚╚╩╚╩╝█
